1111111111111111111111111111111111111111111111111111111
1010000000C00000000000000011111110000000000000000000001
1000111110000000000000000000000000000111000000C00000001
1000111110000000000000000000000000000111000000C00000001
1000111110000000000000000000000000000111000000C00000001
1000111110000000000000000000000000000111000000C00000001
1000111110000000000000000000000000000111000000C00000001
10P11E0000000000000000000000000000C001C0000000000000001
1000000000000000000000000000000000000000000000000000001
1000111111110011000010000100001000011111100000011000101
1000000110000111100010001110011100010000000000010100101
1000000110001100110010010001100010011100000000010010101
1011000110001111110010010000000010010000000000010001101
1011111100001000010010010000000010011111100110010000101
1000000000000000000000000000000000000000000000000000001
1111111111111111111111111111111111111111111111111111111